- Damm, it is raining a lot. Everyone is still drunk at the party and it seems like no one is home. To make things worse, the power is out at the fraternity. - said David
party_game
An Interactive Fiction by Party Group
Release 1 / Serial number 210131 / Inform 7 build 6M62 (I6/v6.33 lib 6/12N) SD

Porch
You can see Main door, Main key, Wooden chair, Old box (in which are flashlight and batteries) and bucket (empty) here.

>n
(first opening Main door)
It seems to be locked.

>n
Living Room

>s
Hall

* * *

>n
(first opening Main door)
It seems to be locked.

>up
Upper Hall
You can see Stairs here.

* * *

>n
(first opening Main door)
It seems to be locked.

>unlock Main door
What do you want to unlock Main door with?

* * *

>n
(first opening Main door)
It seems to be locked.

I beg your pardon?

I beg your pardon?

* * *

- Damm, it is raining a lot. Everyone is still drunk at the party and it seems like no one is home. To make things worse, the power is out at the fraternity. - said David
party_game
An Interactive Fiction by Party Group
Release 1 / Serial number 210131 / Inform 7 build 6M62 (I6/v6.33 lib 6/12N) SD

Porch
You can see Main door, Main key, Wooden chair, Old box (in which are flashlight and batteries) and bucket (empty) here.

>look
Porch
You can see Main door, Main key, Wooden chair, Old box (in which are flashlight and batteries) and bucket (empty) here.

>up
You can't go that way.

>n
Hall
You can see Stairs here.

>look
Hall
You can see Stairs here.

>n
Living Room

>s
Hall
You can see Stairs here.

>s
Porch
You can see You here.

>n
Hall
You can see Stairs here.

>e
Lavabo

>w
Hall
You can see Stairs here.

>up
Upper Hall
You can see Stairs here.

>down
Hall
You can see Stairs here.

>climb stairs
Upper Hall
You can see Stairs here.

>climb stairs
Hall
You can see Stairs here.

>stairs
That's not a verb I recognise.

>enter Living Room
You can't see any such thing.

>enter staris
You can't see any such thing.

>enter stairs
Upper Hall
You can see Stairs here.

* * *

>look
Porch
You can see Main door, Main key, Wooden chair, Old box (in which are flashlight and batteries) and bucket (empty) here.

>get main key
A chill runs up your spine
Taken.

>look
Porch
You can see Main door, Wooden chair, Old box (in which are candle and string) and bucket (empty) here.

>open door
It seems to be locked.

>unlock main door
(with Main key)
You unlock Main door.

>enter door
(first opening Main door)

Hall
You can see Main door here.

>look
Hall
You can see Main door here.

>open main door
That's already open.

>Enter Main Door
Porch
You can see Main door, Wooden chair, Old box (in which are candle and string) and bucket (empty) here.

>Enter Main Door
Hall
You can see Main door here.

>look
Hall
You can see Main door here.

>go north
Living Room

* * *

>get main key
A chill runs up your spine
Taken.

>get Old box
Taken.

>open Old box
It isn't something you can open.

>get flashlight
Taken.

>get batteries
Taken.

>turn on flashlight
It's not much, but that will do.

You switch flashlight on.

>open main door
It seems to be locked.

>open main door whit main key
I only understood you as far as wanting to open Main door.

>use main key in main door
That's not a verb I recognise.

>open main door with main key
You unlock Main door.

>entry main door
That's not a verb I recognise.

>main door
That's not a verb I recognise.

>open mains door
You can't see any such thing.

>l
Porch
You can see Main door, Wooden chair and bucket (empty) here.

>u
You can't go that way.

>open main door
You open Main door.

>f
That's not a verb I recognise.

>up
You can't go that way.

>look
Porch
You can see Main door, Wooden chair and bucket (empty) here.

>go main door
I don't know weather I'm too drunk, but this light is way too dim, someone may be standing right in front of me and I will not see them.

Hall
You just saw something climbing the stairs, you don't know what it was. There are some stairs here.

You can see Main door here.

>n
Living Room
You can see Home Office door here.

>s
I don't know weather I'm too drunk, but this light is way too dim, someone may be standing right in front of me and I will not see them.

Hall
There are some stairs here.

You can see Main door here.

>up
Upper Hall

* * *

>get main key
A chill runs up your spine
Taken.

>get batteries
Taken.

>get flashlight
Taken.

>switch batteries on flashlight
You can't see any such thing.

>n
- Shit, it's locked

>open main door
It seems to be locked.

>n
- Shit, it's locked

>open main door with main key
You unlock Main door.

>enter
You get onto Wooden chair.

>exit
You get off Wooden chair.

Porch
You can see Main door, Wooden chair, Old box (empty) and bucket (empty) here.

>n
- Oh no, can't get into the house because it is way too dark.

>switch on flashlight
- It's not much, but that will do.

You switch flashlight on.

>n
- I don't know weather I'm too drunk, but this light is way too dim, someone may be standing right in front of me and I will not see them.

(first opening Main door)

Hall
You just saw something climbing the stairs, you don't know what it was. There are some stairs here.

You can see Main door here.

>n
Living Room
You can see Home Office door here.

>look
Living Room
You can see Home Office door here.

>o
Sorry, that can't be corrected.

>w
(first opening the Basculante)
It isn't something you can open.

I beg your pardon?

>open Basculante
It isn't something you can open.

>look Basculante
You can see a corpse lying on its back at the garage.

>e
(first opening Home Office door)
It seems to be locked.

>n
Dining Room

>w
kitchen
You can see Garage door here.

>s
(first opening Garage door)
It seems to be locked.

>e
Dining Room

>s
Living Room
You can see Home Office door here.

>s
- I don't know weather I'm too drunk, but this light is way too dim, someone may be standing right in front of me and I will not see them.

Hall
There are some stairs here.

You can see Main door here.

>up
Upper Hall
You can see Bathroom door, Medium Bedroom door, Large Bedroom door and Small Bedroom door here.

>e
Medium Bedroom
You can see Medium Bedroom door here.

>open mediu bedroom door
You can't see any such thing.

>e
You can't go that way.

>look
Medium Bedroom
You can see Medium Bedroom door here.

>w
Upper Hall
You can see Medium Bedroom door, Bathroom door, Large Bedroom door and Small Bedroom door here.

I beg your pardon?

>look
Upper Hall
You can see Medium Bedroom door, Bathroom door, Large Bedroom door and Small Bedroom door here.

>w
(first opening Small Bedroom door)
It seems to be locked.

>go small bedroom
(first opening Small Bedroom door)
It seems to be locked.

>n
Large Bedroom
Somebody Screaming: I shouldn't have done this. But i had loved him too much!  |||  You listen a loud noise. ||| This room is such a mess.

You can see Large Bedroom door and Inner Bathroom door here.

>w
Inner Bathroom
You can see Inner Bathroom door and Jeremy's Corpse (in which is Small Bedroom key) here.

>e
Large Bedroom
This room is such a mess.

You can see Inner Bathroom door and Large Bedroom door here.

>s
Upper Hall
You can see Large Bedroom door, Medium Bedroom door, Bathroom door and Small Bedroom door here.

>s
(first opening Bathroom door)
It seems to be locked.

>n
Large Bedroom
This room is such a mess.

You can see Large Bedroom door and Inner Bathroom door here.

>w
Inner Bathroom
You can see Inner Bathroom door and Jeremy's Corpse (in which is Small Bedroom key) here.

>take key
(Small Bedroom key)
Taken.

* * *

>look
Porch
You can see Main door, Main key, Wooden chair, Old box (in which are flashlight and batteries) and bucket (empty) here.

>open Old box
It isn't something you can open.

>get Old box
Taken.

>look
Porch
You can see Main door, Main key, Wooden chair and bucket (empty) here.

>examine
(Old box)
In Old box are candle and string.

>get candle
Taken.

>light candle
This dangerous act would achieve little.

>get string
Taken.

>examine
What do you want to examine?

>exame both
You can't see any such thing.

>examine both
You can't use multiple objects with that verb.

>examine candle
You see nothing special about candle.

>examine string
You see nothing special about string.

* * *

>look
Porch
You can see Main door, Main key, Wooden chair, Old box (in which are flashlight and batteries) and bucket (empty) here.

>examine
What do you want to examine?

>enter main door
(first opening Main door)
It seems to be locked.

>get main key
A chill runs up your spine
Taken.

>unlock door
(with Main key)
You unlock Main door.

>enter main door
(first opening Main door)

Hall
You can see Main door here.

>look
Hall
You can see Main door here.

* * *

>go north
Living Room

>s
Hall
You can see Main door here.

>s
Porch
You can see Main door, Wooden chair, Old box (in which are candle, string and lighter) and bucket (empty) here.

>get old box
Taken.

I beg your pardon?

>n
Hall
You can see Main door here.

>n
Living Room

>look
Living Room

>w
(first opening the Basculante)
It isn't something you can open.

>examine w
You see nothing unexpected in that direction.

>examine Basculante
You can see a corpse lying on its back at the garage.

* * *

- Damm, it is raining a lot. Everyone is still drunk at the party and it seems like no one is home. To make things worse, the power is out at the fraternity. - said David
party_game
An Interactive Fiction by Party Group
Release 1 / Serial number 210131 / Inform 7 build 6M62 (I6/v6.33 lib 6/12N) SD

Porch
You can see Main door, Main key, Wooden chair, Old box (in which are flashlight and batteries) and bucket (empty) here.

>get key
A chill runs up your spine
Taken.

>unlock door
(with Main key)
You unlock Main door.

>n
(first opening Main door)

Hall
You can see Main door here.

>up
Upper Hall

>down
Hall
You can see Main door here.

* * *

>get key
A chill runs up your spine
Taken.

>unlock door with key
You unlock Main door.

>enter
You get onto Wooden chair.

>out
You get off Wooden chair.

Porch
You can see Main door, Wooden chair, Old box (in which are candle and string) and bucket (empty) here.

>n
(first opening Main door)

Hall
You can see Main door here.

>close door
You close Main door.

>scenes
Scene 'Entire Game' playing (for 6 mins now)
Scene 'Being Outside the House' ended
(Scene monitoring now switched on. Type "scenes off" to switch it off again.)

* * *

- Damm, it is raining a lot. Everyone is still drunk at the party and it seems like no one is home. To make things worse, the power is out at the fraternity. - said David
party_game
An Interactive Fiction by Party Group
Release 1 / Serial number 210131 / Inform 7 build 6M62 (I6/v6.33 lib 6/12N) SD

Porch
You can see Main door, Main key, Wooden chair, Old box (in which are flashlight and batteries) and bucket (empty) here.

>sit
What do you want to sit on?

>sit on wooden chair
You cant sit in it

* * *

- Damm, it is raining a lot. Everyone is still drunk at the party and it seems like no one is home. To make things worse, the power is out at the fraternity. - said David
party_game
An Interactive Fiction by Party Group
Release 1 / Serial number 210131 / Inform 7 build 6M62 (I6/v6.33 lib 6/12N) SD

Porch
You can see Main door, Main key, Wooden chair, Old box (in which are flashlight and batteries) and bucket (empty) here.

>sit on chair
You feel confortable

>look chair
You see nothing special about Wooden chair.

>get wooden chair
That's fixed in place.

>enter chair
That's not something you can enter.

* * *

>sit on chair
You feel confortable

>look
Porch (on Wooden chair)
You can see Main door, Main key and You here.

* * *

>sit on chair
You feel confortable

>up
(first getting off Wooden chair)
You can't go that way.

* * *

>sit on chair
You feel confortable

>out
You get off Wooden chair.

Porch
You can see Main door, Main key, You, Wooden chair, Old box (empty), thing1, thing2 and thing3 here.

>get thing1
Taken.

>put thing1 on chair
You put thing1 on Wooden chair.

>sit on chair
You can't sit in the Wooden chair, it is occupied

* * *

>look
Porch
You can see Main door, Main key, You, Wooden chair (on which is thing1), Old box (empty), thing2 and thing3 here.

I beg your pardon?

>out
But you aren't in anything at the moment.

>look
Porch
You can see Main door, Main key, You, Wooden chair (on which is thing1), Old box (empty), thing2 and thing3 here.

* * *

- Damm, it is raining a lot. Everyone is still drunk at the party and it seems like no one is home. To make things worse, the power is out at the fraternity. - said David
party_game
An Interactive Fiction by Party Group
Release 1 / Serial number 210131 / Inform 7 build 6M62 (I6/v6.33 lib 6/12N) SD

Porch
You can see Main door, Main key, Wooden chair, Old box (in which are flashlight and batteries) and bucket (empty) here.

>enter chair
You get onto Wooden chair.

>out
You get off Wooden chair.

Porch
You can see Main door, Main key, You and Wooden chair here.

>sit on chair
You cant sit in it

>is chair seatable?
That's not a verb I recognise.

>help
That's not a verb I recognise.

* * *

- Damm, it is raining a lot. Everyone is still drunk at the party and it seems like no one is home. To make things worse, the power is out at the fraternity. - said David
party_game
An Interactive Fiction by Party Group
Release 1 / Serial number 210131 / Inform 7 build 6M62 (I6/v6.33 lib 6/12N) SD

Porch
You can see Main door, Main key, Wooden chair, Old box (in which are flashlight and batteries) and bucket (empty) here.

>test me
>--> No test scripts exist for this game.

* * *

- Damm, it is raining a lot. Everyone is still drunk at the party and it seems like no one is home. To make things worse, the power is out at the fraternity. - said David
party_game
An Interactive Fiction by Party Group
Release 1 / Serial number 210131 / Inform 7 build 6M62 (I6/v6.33 lib 6/12N) SD

Porch
You can see Main door, Main key, Wooden chair, Old box (in which are flashlight and batteries) and bucket (empty) here.

>sit on box
You can't sit on Old box

>look
Porch
You can see Main door, Main key, You, Wooden chair and Old box (empty) here.

>enter bpx
You can't see any such thing.

>enter box
That's not something you can enter.

* * *

>sit on box
You can't sit on Old box

>sit on chair
You can't sit on Wooden chair
You feel confortable

* * *

>sit on box
You can't sit on Old box

>get box
Taken.

>put box on chair
You put Old box on Wooden chair.

>sit chair
I didn't understand that sentence.

>sit on chair
You can't sit in a occupied chair

>get box
Taken.

>sit on chair
You feel confortable

* * *

>look
Porch (on Wooden chair)
You can see Main door, Main key and You here.

>get key
A chill runs up your spine
Taken.

* * *

>sit on box
You can't sit on Old box

>enter box
That's not something you can enter.

>enter chair
You get onto Wooden chair.

>look
Porch (on Wooden chair)
You can see Main door, Main key, You, Old box (empty), thing1, thing2 and thing3 here.

>get all
Main key: A chill runs up your spine
Taken.
You: Taken.
Old box: Taken.
thing1: Taken.
thing2: Taken.
thing3: Taken.

>i
You are carrying:
  thing3
  thing2
  thing1
  Old box
  You
  Main key

>drop me
You lack the dexterity.

>drop all
thing3: There is no more room on Wooden chair.
thing2: There is no more room on Wooden chair.
thing1: There is no more room on Wooden chair.
Old box: There is no more room on Wooden chair.
You: There is no more room on Wooden chair.
Main key: There is no more room on Wooden chair.

>exit
You get off Wooden chair.

Porch
You can see Main door and Wooden chair here.

>drop all
thing3: Dropped.
thing2: Dropped.
thing1: Dropped.
Old box: Dropped.
You: Dropped.
Main key: Dropped.

>get me
You are always self-possessed.

>i
You are carrying nothing.

>get all
Main key: A chill runs up your spine
Taken.
You: Taken.
Old box: Taken.
thing1: Taken.
thing2: Taken.
thing3: Taken.

* * *

>i
You are carrying:
  thing3
  thing2
  thing1
  Old box
  You
  Main key

>actions
Actions listing on.

>rules
Rules tracing now switched on. Type "rules off" to switch it off again, or "rules all" to include even rules which do not apply.

>actions off
Actions listing off.

>rules off
Rules tracing now switched off. Type "rules" to switch it on again.

>drop all
thing3: Dropped.
thing2: Dropped.
thing1: Dropped.
Old box: Dropped.
You: Dropped.
Main key: Dropped.

>get all
Main key: A chill runs up your spine
Taken.
You: Taken.
Old box: Taken.
thing1: Taken.
thing2: Taken.
thing3: Taken.

* * *

- Damm, it is raining a lot. Everyone is still drunk at the party and it seems like no one is home. To make things worse, the power is out at the fraternity. - said David
party_game
An Interactive Fiction by Party Group
Release 1 / Serial number 210131 / Inform 7 build 6M62 (I6/v6.33 lib 6/12N) SD

Porch
You can see Main door, Main key, Wooden chair, Old box (in which are flashlight and batteries) and bucket (empty) here.

>get box
Taken.

* * *

>sit chair
I didn't understand that sentence.

>sit on chair
You cant sit in a occupied chair

* * *

>get box
Taken.

>get candle
Taken.

>get lighter
Taken.

>light candle
This dangerous act would achieve little.

>light candle with lighter
I only understood you as far as wanting to light candle.

>light candle
This dangerous act would achieve little.

>candle
That's not a verb I recognise.

>examine candle
You see nothing special about candle.

* * *

>light candle
This dangerous act would achieve little.

>lit candle
That's not a verb I recognise.

* * *

>get lighter
Taken.

>turn on candle
It isn't something you can switch.

* * *

>light candle
This dangerous act would achieve little.

>turn on calde
You can't see any such thing.

>turn on candle
You must supply a noun.

>turn on candle with lighter
You can't see any such thing.

>get lighter
Taken.

>turn on candle with lighter
You can't see any such thing.

>examine
What do you want to examine?

* * *

- Damm, it is raining a lot. Everyone is still drunk at the party and it seems like no one is home. To make things worse, the power is out at the fraternity. - said David
party_game
An Interactive Fiction by Party Group
Release 1 / Serial number 210131 / Inform 7 build 6M62 (I6/v6.33 lib 6/12N) SD

Porch
You can see Main door, Main key, Wooden chair, Old box (in which are flashlight and batteries) and bucket (empty) here.

>examine
What do you want to examine?

>look
Porch
You can see Main door, Main key, Wooden chair, Old box (in which are candle and string) and bucket (empty) here.

* * *

- Damm, it is raining a lot. Everyone is still drunk at the party and it seems like no one is home. To make things worse, the power is out at the fraternity. - said David
party_game
An Interactive Fiction by Party Group
Release 1 / Serial number 210131 / Inform 7 build 6M62 (I6/v6.33 lib 6/12N) SD

Porch
You can see Main door, Main key, Wooden chair, Old box (in which are flashlight and batteries) and bucket (empty) here.

>get kain key
You can't see any such thing.

>get main key
A chill runs up your spine
Taken.

* * *

>unlock door
(with Main key)
You unlock Main door.

>enter door
(first opening Main door)

Hall
You can see Main door here.

* * *

>look
Hall
You can see Main door here.

>e
Lavabo

>w
Hall
You can see Main door here.

>e
Lavabo

>s
You can't go that way.

>n
You can't go that way.

>e
You can't go that way.

>s
You can't go that way.

>w
Hall
You can see Main door here.

>w
You can't go that way.

>n
Living Room

* * *

- Damm, it is raining a lot. Everyone is still drunk at the party and it seems like no one is home. To make things worse, the power is out at the fraternity. - said David
party_game
An Interactive Fiction by Party Group
Release 1 / Serial number 210131 / Inform 7 build 6M62 (I6/v6.33 lib 6/12N) SD

Porch
You can see Main door, Main key, Wooden chair, Old box (in which are flashlight and batteries) and bucket (empty) here.

>enter hall
You can't see any such thing.

>enter Hall
You can't see any such thing.

>get main key
A chill runs up your spine
Taken.

* * *

- Damm, it is raining a lot. Everyone is still drunk at the party and it seems like no one is home. To make things worse, the power is out at the fraternity. - said David
party_game
An Interactive Fiction by Party Group
Release 1 / Serial number 210131 / Inform 7 build 6M62 (I6/v6.33 lib 6/12N) SD

Porch
You can see Main door, Main key, Wooden chair, Old box (in which are flashlight and batteries) and bucket (empty) here.

>get main key
A chill runs up your spine
Taken.

* * *

>unlock door
(with Main key)
You unlock Main door.

>enter
You get onto Wooden chair.

>examine
(Main key)
You see nothing special about Main key.

>stand up
You get off Wooden chair.

Porch
You can see Main door, Wooden chair, Old box (in which are candle and string) and bucket (empty) here.

>go through door
(first opening Main door)

Hall
You can see Main door here.

* * *

>unlock door
(with Main key)
You unlock Main door.

>go to main door
You can't see any such thing.

>enter main door
(first opening Main door)

    *** gg ***

Would you like to RESTART, RESTORE a saved game, QUIT or UNDO the last command?

* * *

>unlock door
(with Main key)
You unlock Main door.

>enter door
Oh no, can't get into the house because it is way too dark.

>look
Hall
You can see Main door here.

>w
You can't go that way.

* * *

>enter door
Oh no, can't get into the house because it is way too dark.

>n
Living Room

>w
(first opening the Basculante)
It isn't something you can open.

>look w
You see nothing unexpected in that direction.

>look basculante
You can see a corpse lying on its back in the garage.

* * *

>enter door
Oh no, can't get into the house because it is way too dark.

>enter door
Oh no, can't get into the house because it is way too dark.

>look
Porch
You can see Main door, Wooden chair, Old box (in which are candle, string and lighter) and bucket (empty) here.

>get old box
Taken.

>get light
You can't see any such thing.

>get candle
Taken.

* * *

>enter door
Oh no, can't get into the house because it is way too dark.

>get old box
Taken.

>get candle
Taken.

* * *

>get lighter
Taken.

>turn on candle
You switch candle on.

>turn on candle
That's already on.

* * *

>unlock door
(with Main key)
You unlock Main door.

>enter dooe
You can't see any such thing.

>enter door
(first opening Main door)

Hall
You can see Main door here.

>n
Living Room

>n
Dining Room

>e
You can't go that way.

>s
Living Room

>w
blue window

>e
Living Room

>n
Dining Room

* * *

>e
You can't go that way.

>loo
That's not a verb I recognise.

>look
Dining Room

>w
Kitchen

>s
Garage
You can see Corpse here.

>w
You can't go that way.

>e
blue window

>e
Living Room

>w
blue window

>n
You can't go that way.

* * *

>w
(first opening the Basculante)
It isn't something you can open.

>lok
That's not a verb I recognise.

>look
Living Room

>examine Basculante
You can see a corpse lying on its back in the garage.

* * *

>get main key
A chill runs up your spine
Taken.

>get old box
Taken.

>examine old box
In Old box are candle and lighter.

>unlock door
What do you want to unlock Main door with?

>unlock door with main key
You unlock Main door.

>enter door
Oh no, can't get into the house because it is way too dark.

>examine old box
In Old box are candle and lighter.

* * *

>get old box
Taken.

>get flashlight
Taken.

* * *

>get batteries
Taken.

>unlock door with main key
You unlock Main door.

* * *

>enter door
Oh no, can't get into the house because it is way too dark.

>switch on flashlight
It's not much, but that will do.

You switch flashlight on.

>enter door
I don't know weather I'm too drunk, but this light is way too dim, someone may be standing right in front of me and I will not see them.

(first opening Main door)

Hall
You can see Main door here.

>n
Living Room

>s
I don't know weather I'm too drunk, but this light is way too dim, someone may be standing right in front of me and I will not see them.

Hall
You can see Main door here.

>n
Living Room

* * *

>get batteries
Taken.

>switch on flashlight
It's not much, but that will do.

You switch flashlight on.

>unlock main door
What do you want to unlock Main door with?

>unlock main door with main key
You unlock Main door.

>enter door
I don't know weather I'm too drunk, but this light is way too dim, someone may be standing right in front of me and I will not see them.

(first opening Main door)

Hall
You just saw something climbing the stairs, you don't know what it was. There are some stairs here.

You can see Main door here.

>s
Porch
You can see Main door, Wooden chair and bucket (empty) here.

>n
I don't know weather I'm too drunk, but this light is way too dim, someone may be standing right in front of me and I will not see them.

Hall
There are some stairs here.

You can see Main door here.

>s
Porch
You can see Main door, Wooden chair and bucket (empty) here.

* * *

>get main key
A chill runs up your spine
Taken.

>onem main door with main key
That's not a verb I recognise.

>opem main door with main key
That's not a verb I recognise.

>open main door with main key
You unlock Main door.

>get old box
Taken.

* * *

>get batteries
Taken.

>swtich on flashlight
That's not a verb I recognise.

>switch on flashlight
- It's not much, but that will do.

You switch flashlight on.

>go main door
- I don't know weather I'm too drunk, but this light is way too dim, someone may be standing right in front of me and I will not see them.

(first opening Main door)

Hall
You just saw something climbing the stairs, you don't know what it was. There are some stairs here.

You can see Main door here.

>up
Upper Hall
- Shit! What sond was that?

>w
Small Bedroom
You can see Drawer (in which is Home Office key) here.

* * *

>get main key
A chill runs up your spine
Taken.

>get flashlight
Taken.

* * *

>get batteries
Taken.

>switch on flashlight
- It's not much, but that will do. - said David
You switch flashlight on.

>open main door with main key
You unlock Main door.

>go main door
- I don't know weather I'm too drunk, but this light is way too dim, someone may be standing right in front of me and I will not see them. - said David
(first opening Main door)

Hall
You just saw something climbing the stairs, you don't know what it was. There are some stairs here.

You can see Main door and alarm (empty) here.

>up
Upper Hall
You hear moans coming from the Large Bedroom. The place is very dark and very cold

You can see Bathroom door, Medium Bedroom door, Large Bedroom door and Small Bedroom door here.

>look
Upper Hall
 you can see a Small Badroom door at weast,

* * *

>up
Upper Hall
You hear moans coming from the Large Bedroom. The place is very dark and very cold

You can see Bathroom door, Medium Bedroom door, Large Bedroom door and Small Bedroom door here.

>go medium bedroom door
(first opening Medium Bedroom door)
It seems to be locked.

>open medium bedroom door
It seems to be locked.

* * *

>up
Upper Hall
You hear moans coming from the Large Bedroom. The place is very dark and very cold

You can see Bathroom door, Medium Bedroom door, Large Bedroom door and Small Bedroom door here.

>go medium bedroom
Medium Bedroom
You can see Medium Bedroom door here.

>s
You can't go that way.

>e
You can't go that way.

>w
Upper Hall
You can see Medium Bedroom door and Small Bedroom door here.

>go Small Bedroom
(first opening Small Bedroom door)
It seems to be locked.

* * *

>up
Upper Hall
You hear moans coming from the Large Bedroom. The place is very dark and very cold

You can see Bathroom door, Medium Bedroom door, Large Bedroom door and Small Bedroom door here.

>go Large Bedroom door
Large Bedroom
Somebody Screaming: I shouldn't have done this. But I had loved him too much!  
 You listen a loud noise. 
 This room is such a mess.

You can see Large Bedroom door, Inner Bathroom door and Bed (in which is Smartphone) here.

>go Inner Bath
You can't see any such thing.

>go Inner Bathroom door
Inner Bathroom
You can see Inner Bathroom door and Jeremy's Corpse (in which is Small Bedroom key) here.

>take Small Bedroom
Taken.

>back
That's not a verb I recognise.

>go to inner Bathroom door
You can't see any such thing.

>go inner Bathroom door
Large Bedroom
This room is such a mess.

You can see Inner Bathroom door and Large Bedroom door here.

>go large bedroom door
Upper Hall
You can see Large Bedroom door, Bathroom door, Medium Bedroom door and Small Bedroom door here.

>open Small bedroom door
It seems to be locked.

I beg your pardon?

* * *

>go Large Bedroom door
Large Bedroom
Somebody Screaming: I shouldn't have done this. But I had loved him too much!  
 You listen a loud noise. 
 This room is such a mess.

You can see Large Bedroom door, Inner Bathroom door and Bed (in which is Smartphone) here.

>go Inner Bathroom door
Inner Bathroom
You can see Inner Bathroom door and Jeremy's Corpse (in which is Small Bedroom key) here.

>take Small Bedroom key
Taken.

>go Inner Bathroom door
Large Bedroom
This room is such a mess.

You can see Inner Bathroom door and Large Bedroom door here.

>go Large Bedroom door
Upper Hall
You can see Large Bedroom door, Bathroom door, Medium Bedroom door and Small Bedroom door here.

>opem Small Bedroom door with small Bedroom key
That's not a verb I recognise.

>open Small Bedroom door with small Bedroom key
You unlock Small Bedroom door.

>go Small Bedroom door
(first opening Small Bedroom door)

Small Bedroom
You can see Small Bedroom door and Drawer (in which is Home Office key) here.

>take  Home Office key
Taken.

* * *

>go Large Bedroom door
Upper Hall
You can see Large Bedroom door, Bathroom door, Medium Bedroom door and Small Bedroom door here.

>open Small Bedroom door with small Bedroom key
You unlock Small Bedroom door.

* * *

>go Small Bedroom door
(first opening Small Bedroom door)

Small Bedroom
You can see Small Bedroom door and Drawer (in which is Home Office key) here.

>take Home Office key
Taken.

* * *

>go Large Bedroom door
Large Bedroom
Somebody Screaming: I shouldn't have done this. But I had loved him too much!  
 You listen a loud noise. 
 This room is such a mess.

You can see Large Bedroom door, Inner Bathroom door and Bed (in which is Smartphone) here.

>take smartphone
Taken.

>look smartphone
"Whatsapp -  Chat with Margaret"
 Jeremy - Margaret I love him!
 Margaret -  Who?
 Jeremy - David! I can't hide this feeling anymore.
 Margaret - OMG! I couldn't imagine! Tell him...
 Jeremy - How? I have no courage. What if he rejects me?
 Margaret - Friend, I know how to help you.
 Margaret - On Friday there will be a party, in a way that David won't go to the party. The fraternity will be empty. It will be your chance.
 Margaret - I have some pills here that will make you very stoned. And the rest is up to you, just declare yourself.
 Jeremy - Margaret, you are crazy!
 Margaret - Friend, trust! And in the worst case scenario, you just pretend you were really crazy and don't remember anything.

- WOW!  Jeremy loves me ??? - said David. ...

>look smartphone
"Whatsapp -  Chat with Margaret"
 Jeremy - Margaret I love him!
 Margaret -  Who?
 Jeremy - David! I can't hide this feeling anymore.
 Margaret - OMG! I couldn't imagine! Tell him...
 Jeremy - How? I have no courage. What if he rejects me?
 Margaret - Friend, I know how to help you.
 Margaret - On Friday there will be a party, in a way that David won't go to the party. The fraternity will be empty. It will be your chance.
 Margaret - I have some pills here that will make you very stoned. And the rest is up to you, just declare yourself.
 Jeremy - Margaret, you are crazy!
 Margaret - Friend, trust! And in the worst case scenario, you just pretend you were really crazy and don't remember anything.

...

>go Inner Bathroom door
Inner Bathroom
- Jeramy !! What's going on here?? Whose body is that in the garage?
- Jeramy ??? - said David - Jeramy... - said David 

You can see Inner Bathroom door and Jeremy's Corpse (in which is Small Bedroom key) here.

* * *

>up
Upper Hall
You hear moans coming from the Large Bedroom. The place is very dark and very cold

You can see Bathroom door, Medium Bedroom door, Large Bedroom door and Small Bedroom door here.

>n
Large Bedroom
Somebody Screaming: I shouldn't have done this. But I had loved him too much!  
 You listen a loud noise. 
 This room is such a mess.

You can see Large Bedroom door, Inner Bathroom door and Bed (in which is Smartphone) here.

>w
- Jeramy !! What happened? Why are you crying?  - said David
- Jeramy ??? - said David 
- Jeramy... - said David 
Inner Bathroom
You can see Inner Bathroom door and Jeremy's Corpse (in which is Small Bedroom key) here.

>e
Large Bedroom
This room is such a mess.

You can see Inner Bathroom door, Large Bedroom door and Bed (in which is Smartphone) here.

>w
Jeramy... - said David 
Inner Bathroom
You can see Inner Bathroom door and Jeremy's Corpse (in which is Small Bedroom key) here.

>e
Large Bedroom
This room is such a mess.

You can see Inner Bathroom door, Large Bedroom door and Bed (in which is Smartphone) here.

>s
Upper Hall
The place is very dark and very cold

You can see Large Bedroom door, Bathroom door, Medium Bedroom door and Small Bedroom door here.

>d
- I don't know weather I'm too drunk, but this light is way too dim, someone may be standing right in front of me and I will not see them. - said David
Hall
There are some stairs here.

You can see Main door and alarm (empty) here.

>n
Living Room
You have a strange feeling when looking at the Basculante on your left. There are some Basculante here.

You can see Home Office door here.

>e
(first opening Home Office door)
It seems to be locked.

>look basculante
You can see a corpse lying on its back at the garage.
- Shit! That is a body. - said David

>s
- I don't know weather I'm too drunk, but this light is way too dim, someone may be standing right in front of me and I will not see them. - said David
Hall
There are some stairs here.

You can see Main door and alarm (empty) here.

>u
Upper Hall
The place is very dark and very cold

You can see Large Bedroom door, Bathroom door, Medium Bedroom door and Small Bedroom door here.

>n
Large Bedroom
This room is such a mess.

You can see Large Bedroom door, Inner Bathroom door and Bed (in which is Smartphone) here.

>w
- Jeramy !! What's going on here?? Whose body is that in the garage?
- Jeramy ??? - said David
 - Jeramy... - said David 
Inner Bathroom
You can see Inner Bathroom door and Jeremy's Corpse (in which is Small Bedroom key) here.

>e
Large Bedroom
This room is such a mess.

You can see Inner Bathroom door, Large Bedroom door and Bed (in which is Smartphone) here.

>take smartphone
Taken.

* * *

>w
Jeramy... - said David 
Inner Bathroom
You can see Inner Bathroom door and Jeremy's Corpse (in which is Small Bedroom key) here.

>take small bedrrom
I only understood you as far as wanting to take Small Bedroom key.

>take small bedroom
Taken.

>e
Large Bedroom
This room is such a mess.

You can see Inner Bathroom door, Large Bedroom door and Bed (empty) here.

>s
Upper Hall
The place is very dark and very cold

You can see Large Bedroom door, Bathroom door, Medium Bedroom door and Small Bedroom door here.

>unlocked small bedroom with samll badroom key
That's not a verb I recognise.

>unlock small bedroom with samll badroom key
You can't see any such thing.

>unlock small bedroom door with samll badroom key
You can't see any such thing.

>unlock small bedroom door with small badroom key
You can't see any such thing.

>open small bedroom door
It seems to be locked.

>open small bedroom door with small badroom key
You can't see any such thing.

>open small bedroom door with small bedroom key
You unlock Small Bedroom door.

>go small bedroom
(Small Bedroom key)
That's not something you can enter.

>go to small bedroom
You can't see any such thing.

>e
Medium Bedroom
You can see Medium Bedroom door here.

>w
Upper Hall
The place is very dark and very cold

You can see Medium Bedroom door, Large Bedroom door, Bathroom door and Small Bedroom door here.

>w
(first opening Small Bedroom door)

Small Bedroom
You can see Small Bedroom door and Drawer (in which are Home Office key and Fuses) here.

>take home office key
Taken.

>w
You can't go that way.

>e
Upper Hall
The place is very dark and very cold

You can see Small Bedroom door, Medium Bedroom door, Large Bedroom door and Bathroom door here.

>d
- I don't know weather I'm too drunk, but this light is way too dim, someone may be standing right in front of me and I will not see them. - said David
Hall
There are some stairs here.

You can see Main door and alarm (empty) here.

>n
Living Room
There are some Basculante here.

You can see Home Office door here.

>open home office with home office key
(Home Office key with Home Office key)
That doesn't seem to be something you can unlock.

>open home office door with home office key
You unlock Home Office door.

>e
(first opening Home Office door)

Home Office
You can see Home Office door and Wooden Table (in which is Garage key) here.

>take garage key
Taken.

>e
You can't go that way.

>n
You can't go that way.

>w
Living Room
There are some Basculante here.

You can see Home Office door here.

>n
Dining Room

* * *

>w
kitchen
You can see Garage door here.

>w
You can't go that way.

>s
(first opening Garage door)
It seems to be locked.

>open garage door with garage key
You unlock Garage door.

>s
(first opening Garage door)

Garage
My God, I don't know if I have the courage to see who it is. -
Shit Shit. - said David

You can see Garage door, Corpse and circuit breaker (empty) here.

>go to garage
You can't see any such thing.

>go garage door
kitchen
You can see Garage door here.

>s
Garage
-
Shit Shit. - said David

You can see Garage door, Corpse and circuit breaker (empty) here.

>look
Garage
-
Shit Shit. - said David

You can see Garage door, Corpse and circuit breaker (empty) here.

>open garage door
That's already open.

>s
You can't go that way.

>s
You can't go that way.

>look corpes
You can't see any such thing.

>look Corpse
- No way! It's me...  - said David
David is shocked to see that the body is himself.
- I died??? - said David
Then the body starts to struggle, as if it were having a convusion.
- Shit Shit Shit... I'm still alive!  - said David
-I need to get help! Jeremy ... I need to call jeremy.-said David

>look
Garage
-
Shit Shit. - said David

You can see Garage door, Corpse and circuit breaker (empty) here.

>switch on circuit breaker
- I need some Fuses. - said David

>put batteries on circuit breaker
Putting things on circuit breaker would achieve nothing.

>put batteries on circuit breaker
Putting things on circuit breaker would achieve nothing.

>look
Garage
-
Shit Shit. - said David

You can see Garage door, Corpse and circuit breaker (empty) here.

>iventory
That's not a verb I recognise.

>inventory
You are carrying:
  Garage key
  Home Office key
  Small Bedroom key
  Smartphone
  batteries
  flashlight
  Main key

>put batteries in circuit breaker
You put batteries into circuit breaker.

>switch on circuit breaker
- I need some Fuses. - said David

>look
Garage
-
Shit Shit. - said David

You can see Garage door, Corpse and circuit breaker (in which is batteries) here.

>take batteries
Taken.

>switch on circuit breaker
- I need some Fuses. - said David

>put batteries in circuit breaker
You put batteries into circuit breaker.

* * *

>take batteries
Taken.

>n
kitchen
You can see Garage door here.

>e
Dining Room

>s
Living Room
There are some Basculante here.

You can see Home Office door here.

>s
- I don't know weather I'm too drunk, but this light is way too dim, someone may be standing right in front of me and I will not see them. - said David
Hall
There are some stairs here.

You can see Main door and alarm (empty) here.

>up
Upper Hall
The place is very dark and very cold

You can see Small Bedroom door, Medium Bedroom door, Large Bedroom door and Bathroom door here.

>w
Small Bedroom
You can see Small Bedroom door and Drawer (in which is Fuses) here.

>take fuses
Taken.

>e
Upper Hall
The place is very dark and very cold

You can see Small Bedroom door, Medium Bedroom door, Large Bedroom door and Bathroom door here.

* * *

>n
Living Room
There are some Basculante here.

You can see Home Office door here.

>w
(first opening the Basculante)
It isn't something you can open.

>n
Dining Room

* * *

>w
kitchen
You can see Garage door here.

>s
Garage
-
Shit Shit. - said David

You can see Garage door, Corpse and circuit breaker (empty) here.

>put fuses on circuit breaker
Putting things on circuit breaker would achieve nothing.

>look
Garage
-
Shit Shit. - said David

You can see Garage door, Corpse and circuit breaker (empty) here.

>put fuses on circuit breaker
Putting things on circuit breaker would achieve nothing.

>put batteries in circuit breaker
You put batteries into circuit breaker.

>look
Garage
-
Shit Shit. - said David

You can see Garage door, Corpse and circuit breaker (in which is batteries) here.

>put fuses on circuit breaker
Putting things on circuit breaker would achieve nothing.

>put fuses in circuit breaker
You put Fuses into circuit breaker.

>take batteries
Taken.

>switch on circuit breaker
- The energy of the house is back! I can set the alarm to get Jeremy's attention. - said David

>n
kitchen
You can see Garage door here.

* * *

>s
Living Room
There are some Basculante here.

You can see Home Office door here.

>s
- I don't know weather I'm too drunk, but this light is way too dim, someone may be standing right in front of me and I will not see them. - said David
Hall
There are some stairs here.

You can see Main door and alarm (empty) here.

Your time is up, you died!
GAME OVER

    *** The End ***

Would you like to RESTART, RESTORE a saved game, QUIT or UNDO the last command?

>switch on alarm
Please give one of the answers above.

Would you like to RESTART, RESTORE a saved game, QUIT or UNDO the last command?

>put batteries in alarm
Please give one of the answers above.

Would you like to RESTART, RESTORE a saved game, QUIT or UNDO the last command?

>switch on alarm
Please give one of the answers above.

Would you like to RESTART, RESTORE a saved game, QUIT or UNDO the last command?

* * *

>go main door
- I don't know weather I'm too drunk, but this light is way too dim, someone may be standing right in front of me and I will not see them. - said David
(first opening Main door)

Hall
You just saw something climbing the stairs, you don't know what it was. There are some stairs here.

You can see Main door and alarm (empty) here.

>north
Living Room
You have a strange feeling when looking at the Basculante on your left. There are some Basculante here.

You can see Home Office door here.

>go Basculante
(first opening the Basculante)
It isn't something you can open.

>open Basculante
It isn't something you can open.

* * *

>look Basculante
You can see a corpse lying on its back at the garage.

>s
- I don't know weather I'm too drunk, but this light is way too dim, someone may be standing right in front of me and I will not see them. - said David
Hall
There are some stairs here.

You can see Main door here.

>n
Living Room
There are some Basculante here.

You can see Home Office door here.

>s
- I don't know weather I'm too drunk, but this light is way too dim, someone may be standing right in front of me and I will not see them. - said David
Hall
There are some stairs here.

You can see Main door here.

>up
Upper Hall
You hear moans coming from the Large Bedroom. The place is very dark and very cold

You can see Bathroom door, Medium Bedroom door, Large Bedroom door and Small Bedroom door here.

* * *

>n
Large Bedroom
Somebody Screaming: I shouldn't have done this. But I had loved him too much!  
 You listen a loud noise. 
 This room is such a mess.

You can see Large Bedroom door, Inner Bathroom door and Bed (in which is Smartphone) here.

>e
You can't go that way.

>w
- Jeramy !! What's going on here?? Whose body is that in the garage?
- Jeramy ??? - said David - Jeramy... - said David 
Inner Bathroom
You can see Inner Bathroom door and Jeremy's Corpse (in which is Small Bedroom key) here.

* * *

>north
Living Room
You have a strange feeling when looking at the Basculante on your left. There are some Basculante here.

You can see Home Office door here.

>look basculante
You can see a corpse lying on its back at the garage.
- Shit! That is a body. - said David

>south
- I don't know weather I'm too drunk, but this light is way too dim, someone may be standing right in front of me and I will not see them. - said David
Hall
There are some stairs here.

You can see Main door and alarm (empty) here.

>pút batteries in alarm
That's not a verb I recognise.

>put batteries in alarm
You put batteries into alarm.

>switch on alarm
-There is no power. - said David

>take batteries
Taken.

>up
Upper Hall
You hear moans coming from the Large Bedroom. The place is very dark and very cold

You can see Bathroom door, Medium Bedroom door, Large Bedroom door and Small Bedroom door here.

>north
Large Bedroom
Somebody Screaming: I shouldn't have done this. But I had loved him too much!  
 You listen a loud noise. 
 This room is such a mess.

You can see Large Bedroom door, Inner Bathroom door and Bed (in which is Smartphone) here.

>west
- Jeramy !! What's going on here?? Whose body is that in the garage?
- Jeramy ??? - said David
 - Jeramy... - said David 
Inner Bathroom
You can see Inner Bathroom door and Jeremy's Corpse (in which is Small Bedroom key) here.

>get main small key
I only understood you as far as wanting to get Main key.

>get small key
Taken.

>east
Large Bedroom
This room is such a mess.

You can see Inner Bathroom door, Large Bedroom door and Bed (in which is Smartphone) here.

>south
Upper Hall
The place is very dark and very cold

You can see Large Bedroom door, Bathroom door, Medium Bedroom door and Small Bedroom door here.

>open Small Bedroom door with small Bedroom key
You unlock Small Bedroom door.

>go Small Bedroom door
(first opening Small Bedroom door)

Small Bedroom
You can see Small Bedroom door and Drawer (in which are Home Office key and Fuses) here.

>take Home Office key
Taken.

>take fuses
Taken.

>east
Upper Hall
The place is very dark and very cold

You can see Small Bedroom door, Large Bedroom door, Bathroom door and Medium Bedroom door here.

>down
- I don't know weather I'm too drunk, but this light is way too dim, someone may be standing right in front of me and I will not see them. - said David
Hall
There are some stairs here.

You can see Main door and alarm (empty) here.

>north
Living Room
There are some Basculante here.

You can see Home Office door here.

>open Home Office door with Home Office key
You unlock Home Office door.

>go Home Office door
(first opening Home Office door)

Home Office
You can see Home Office door and Wooden Table (in which is Garage key) here.

>take garage key
Taken.

>west
Living Room
There are some Basculante here.

You can see Home Office door here.

>north
Dining Room

>west
kitchen
You can see Garage door here.

>south
(first opening Garage door)
It seems to be locked.

>open Garage door with Garage key
You unlock Garage door.

>go garage door
(first opening Garage door)

Garage
My God, I don't know if I have the courage to see who it is. -
Shit Shit. - said David

You can see Garage door, Corpse and circuit breaker (empty) here.

>look corpse
- No way! It's me...  - said David
David is shocked to see that the body is himself.
- I died??? - said David
Then the body starts to struggle, as if it were having a convusion.
- Shit Shit Shit... I'm still alive!  - said David
-I need to get help! Jeremy ... I need to call jeremy.-said David

>put fuses in circuit breaker
You put Fuses into circuit breaker.

>switch on circuit breaker
- The energy of the house is back! I can set the alarm to get Jeremy's attention. - said David

>north
kitchen
You can see Garage door here.

>east
Dining Room

>south
Living Room
There are some Basculante here.

You can see Home Office door here.

>south
- I don't know weather I'm too drunk, but this light is way too dim, someone may be standing right in front of me and I will not see them. - said David
Hall
There are some stairs here.

You can see Main door and alarm (empty) here.

>switch on alarm
- I can't believe it, it looks like the alarm battery burned out. - said David

>put batteries in alarm
You put batteries into alarm.

>switch on alarm
- It worked! It worked! - said David
Then the alarm is triggered. Jeremy, go down to the hall believing that the police are at the scene and that he would be arrested. However, when he arrives in the hall, he realizes that there is no one and deactivates the alarm.
Before he can escape the place, Jeremy hears thumps coming from the garage, where he had left David's body. So Jeremy goes to the garage.

- David, you are alive !! I thought I lost you. - said Jeremy
 - I need to call an ambulance. - said Jeremy.

 WIN - You were saved- I can't believe it, it looks like the alarm battery burned out. - said David

    *** The End ***

Would you like to RESTART, RESTORE a saved game, QUIT or UNDO the last command?

* * *

>south
- I don't know weather I'm too drunk, but this light is way too dim, someone may be standing right in front of me and I will not see them. - said David
Hall
There are some stairs here.

You can see Main door and alarm (empty) here.

>up
Upper Hall
You hear moans coming from the Large Bedroom. The place is very dark and very cold

You can see Bathroom door, Large Bedroom door and Small Bedroom door here.

>go Large Bedroom door
Large Bedroom
Somebody Screaming: I shouldn't have done this. But I had loved him too much!  
 You listen a loud noise. 
 This room is such a mess.

You can see Large Bedroom door and Inner Bathroom door here.

>go Inner Bathroom door
- Jeramy !! What's going on here?? Whose body is that in the garage?
- Jeramy ??? - said David
 - Jeramy... - said David 
Inner Bathroom
You can see Inner Bathroom door and Jeremy's body (in which is Small Bedroom key) here.

>get small key
Taken.

>go Inner Bathroom door
Large Bedroom
This room is such a mess.

You can see Inner Bathroom door and Large Bedroom door here.

>go Large Bedroom door
Upper Hall
The place is very dark and very cold

You can see Large Bedroom door, Bathroom door and Small Bedroom door here.

>open Small Bedroom door with small Bedroom ke
You can't see any such thing.

>open Small Bedroom door with small Bedroom key
You unlock Small Bedroom door.

>go Small Bedroom door
(first opening Small Bedroom door)

Small Bedroom
You can see Small Bedroom door, Bed (in which is Smartphone) and Drawer (in which are Home Office key and Fuses) here.

>get Smartphone
Taken.

>look smartphone
"Whatsapp -  Chat with Margaret"
 Jeremy - Margaret I love him!
 Margaret -  Who?
 Jeremy - David! I can't hide this feeling anymore.
 Margaret - OMG! I couldn't imagine! Tell him...
 Jeremy - How? I have no courage. What if he rejects me?
 Margaret - Friend, I know how to help you.
 Margaret - On Friday there will be a party, in a way that David won't go to the party. The fraternity will be empty. It will be your chance.
 Margaret - I have some pills here that will make you very stoned. And the rest is up to you, just declare yourself.
 Jeremy - Margaret, you are crazy!
 Margaret - Friend, trust! And in the worst case scenario, you just pretend you were really crazy and don't remember anything.

- WOW!  Jeremy loves me ??? - said David. ...

>take Home Office key
Taken.

* * *

>take fuses
Taken.

>go Small Bedroom door
Upper Hall
The place is very dark and very cold

You can see Small Bedroom door, Large Bedroom door and Bathroom door here.

>down
- I don't know weather I'm too drunk, but this light is way too dim, someone may be standing right in front of me and I will not see them. - said David
Hall
There are some stairs here.

You can see Main door and alarm (empty) here.

* * *

>open Home Office door with Home Office key
You unlock Home Office door.

>go Home Office door
(first opening Home Office door)

Home Office
Fuck! this room is such a creep! I have no idea why people use this room.
Anyway, all spare keys must be here!

You can see Home Office door, Jeremy's diary and Wooden Table (in which is Garage key) here.

>take Jeremy's diary
Taken.

>look Jeremy's diary
My diller told me that it is safe, two pills and we gonna have fun! 
 I'll do that today, while every one is at the party! 
 We will be a couple! He can`t say not! 
 D. S2S2S2 
 Ps. This is really good, i've just took two pills

>take garage key
Taken.

* * *

>north
Dining Room

>west
kitchen
Why are theres those pills in the floor? Its such a mess, seens like someone has a figth here 

You can see Garage door here.

>open Garage door with Garage key
You unlock Garage door.

* * *

>look corpse
- No way! It's me...  - said David
David is shocked to see that the body is himself.
- I died??? - said David
Then the body starts to struggle, as if it were having a convusion.
- Shit Shit Shit... I'm still alive!  - said David
-I need to get help! Jeremy ... I need to call jeremy.-said David

>switch on circuit breaker
- I need some Fuses. - said David

>put fuses in circuit breaker
You put Fuses into circuit breaker.

* * *

>switch on circuit breaker
- The energy of the house is back! I can set the alarm to get Jeremy's attention. - said David

>north
kitchen
Its such a mess, seens like someone has a figth here 

You can see Garage door here.

>east
Dining Room

* * *

>get main key
A chill runs up your spine
Taken.

>iventory
That's not a verb I recognise.

>inventary
That's not a verb I recognise.

>inventory
You are carrying:
  Main key

>get flashlight
Taken.

* * *

>open main door with main key
You unlock Main door.

>n
- I don't know weather I'm too drunk, but this light is way too dim, someone may be standing right in front of me and I will not see them. - said David
(first opening Main door)

Hall
You just saw something climbing the stairs, you don't know what it was. There are some stairs here.

You can see Main door here.

>n
Living Room
You have a strange feeling when looking at the Basculante on your left. There are some Basculante here.

You can see Home Office door here.

>n
Dining Room

>s
Living Room
There are some Basculante here.

You can see Home Office door here.

>look Basculante
You can see a corpse lying on its back at the garage.

* * *

>s
- I don't know weather I'm too drunk, but this light is way too dim, someone may be standing right in front of me and I will not see them. - said David
Hall
There are some stairs here.

You can see Main door here.

>up
Upper Hall
You hear moans coming from the Large Bedroom. 

You can see Bathroom door, Medium Bedroom door, Large Bedroom door and Small Bedroom door here.

>s
(first opening Bathroom door)
It seems to be locked.

I beg your pardon?

>s
(first opening Bathroom door)
It seems to be locked.

>look
Upper Hall
You hear moans coming from the Large Bedroom. 

You can see Bathroom door, Medium Bedroom door, Large Bedroom door and Small Bedroom door here.

>s
(first opening Bathroom door)
It seems to be locked.

* * *

- Damm, it is raining a lot. Everyone is still drunk at the party and it seems like no one is home. To make things worse, the power is out at the fraternity. - said David
party_game
An Interactive Fiction by Party Group
Release 1 / Serial number 210131 / Inform 7 build 6M62 (I6/v6.33 lib 6/12N) SD

Porch
You can see Main door, Main key, Wooden chair, Old box (in which are flashlight and batteries) and bucket (empty) here.

>bet box
That's not a verb I recognise.

>get box
Taken.

>examine
(Old box)
In Old box are candle and string.

* * *

- Damm, it is raining a lot. Everyone is still drunk at the party and it seems like no one is home. To make things worse, the power is out at the fraternity. - said David
party_game
An Interactive Fiction by Party Group
Release 1 / Serial number 210131 / Inform 7 build 6M62 (I6/v6.33 lib 6/12N) SD

Porch
You can see Main door, Main key, Wooden chair, Old box (in which are flashlight and batteries) and bucket (empty) here.

>get gox
You can't see any such thing.

>get box
Taken.

* * *

>get candle
Taken.

I beg your pardon?

>get lighter
Taken.

>light lighter
This dangerous act would achieve little.

>light candle
This dangerous act would achieve little.

* * *

- Damm, it is raining a lot. Everyone is still drunk at the party and it seems like no one is home. To make things worse, the power is out at the fraternity. - said David
party_game
An Interactive Fiction by Party Group
Release 1 / Serial number 210131 / Inform 7 build 6M62 (I6/v6.33 lib 6/12N) SD

Porch
You can see Main door, Main key, Wooden chair, Old box (in which are flashlight and batteries) and bucket (empty) here.

>get old box
Taken.

* * *

>light candle
This dangerous act would achieve little.

>light with lighter
You can't see any such thing.

>light candle with lighter
I only understood you as far as wanting to light candle.

* * *

>get candle
Taken.

>turn on candle
You switch candle on.

>examine old box
In Old box are string and lighter.

* * *

>get candle
Taken.

>switch on candle
I need something to light the candle.

>get lighter
Taken.

>switch on candle
The candle has been lit.

You switch candle on.

* * *

>light candle
This dangerous act would achieve little.

>light candle
This dangerous act would achieve little.

* * *

>get old box
Taken.

>examine old box
In Old box are flashlight and batteries.

>get flashlight
Taken.

>switch on flashlight
I need some batteries.

>turn on flashlight
I need some batteries.

>get batteries
Taken.

>switch on flashlight
The flashlight has been turned on.

You switch flashlight on.

>get main key
A chill runs up your spine
Taken.

>unlock door
What do you want to unlock Main door with?

* * *

>unlock door with main key
You unlock Main door.

>enter door
It's not much, but that will do
(first opening Main door)

Hall
You can see Main door here.

>n
Living Room

* * *

>look
Living Room

>examien
That's not a verb I recognise.

>examine
What do you want to examine?

>w
You see nothing unexpected in that direction.

>examine w
You see nothing unexpected in that direction.

>look w
You see nothing unexpected in that direction.

>look
Living Room

>go west
(first opening the Basculante)
It isn't something you can open.

>examine basculante
You can see a corpse lying on its back at the garage.

>w
(first opening the Basculante)
It isn't something you can open.

>w
(first opening the Basculante)
It isn't something you can open.

>s
It's not much, but that will do
Hall
You can see Main door here.

>look
Hall
You can see Main door here.

* * *

>e
Lavabo

>e
You can't go that way.

>w
It's not much, but that will do
Hall
You can see Main door here.

>w
You can't go that way.

>look
Hall
You can see Main door here.

>examine
What do you want to examine?

>sei l
You can't see any such thing.

>up
Upper Hall

>down
It's not much, but that will do
Hall
You can see Main door here.

>down
You can't go that way.

>up
Upper Hall

>lok
That's not a verb I recognise.

>look
Upper Hall

>down
It's not much, but that will do
Hall
You can see Main door here.

>w
You can't go that way.

>a
That's not a verb I recognise.

>d
You can't go that way.

>e
Lavabo

>w
It's not much, but that will do
Hall
You can see Main door here.

>s
Porch
You can see Main door, Wooden chair and bucket (empty) here.

>n
It's not much, but that will do
Hall
You can see Main door here.

* * *

>get batteries
Taken.

>switch on flashlight
- It's not much, but that will do.

You switch flashlight on.

>get main key
A chill runs up your spine
Taken.

>use main key in main door
That's not a verb I recognise.

>open main key with main door
(first taking Main door)
That's fixed in place.

>open main door with main key
You unlock Main door.

>go main door
- I don't know weather I'm too drunk, but this light is way too dim, someone may be standing right in front of me and I will not see them.

(first opening Main door)

Hall
You just saw something climbing the stairs, you don't know what it was. There are some stairs here.

You can see Main door here.

* * *

>up
Upper Hall
- Shit! What sond was that?

>left
That's not a verb I recognise.

>l
Upper Hall
- Shit! What sond was that?

>w
Small Bedroom
You can see Desk (in which is Drawer (in which is Home Office key)) here.

* * *

- Damm, it is raining a lot. Everyone is still drunk at the party and it seems like no one is home. To make things worse, the power is out at the fraternity. - said David
party_game
An Interactive Fiction by Party Group
Release 1 / Serial number 210131 / Inform 7 build 6M62 (I6/v6.33 lib 6/12N) SD

Porch
You can see Main door, Main key, Wooden chair, Old box (in which are flashlight and batteries) and bucket (empty) here.

>enter door
Oh no, can't get into the house because it is way too dark.

>take flashlight
Taken.

>swich flashlight
That's not a verb I recognise.

* * *

- Damm, it is raining a lot. Everyone is still drunk at the party and it seems like no one is home. To make things worse, the power is out at the fraternity. - said David
party_game
An Interactive Fiction by Party Group
Release 1 / Serial number 210131 / Inform 7 build 6M62 (I6/v6.33 lib 6/12N) SD

Porch
You can see Main door, Main key, Wooden chair, Old box (in which are flashlight and batteries) and bucket (empty) here.

>enter main door
Shit, it's locked

>taken key
That's not a verb I recognise.

>take key
A chill runs up your spine
Taken.

>unlock main door with main key
You unlock Main door.

* * *

>look
Porch
You can see Main door, Wooden chair, Old box (in which are flashlight and batteries) and bucket (empty) here.

* * *

>open main door
You open Main door.

>enter main door
Oh no, can't get into the house because it is way too dark.

>take flashlight and batteries
flashlight: Taken.
batteries: Taken.

>use batteries on flashlight
That's not a verb I recognise.

>put batteries on flashlight
Putting things on flashlight would achieve nothing.

>switch on flashlight
It's not much, but that will do.

You switch flashlight on.

>look
Porch
You can see Main door, Wooden chair, Old box (empty) and bucket (empty) here.

>enter main door
I don't know weather I'm too drunk, but this light is way too dim, someone may be standing right in front of me and I will not see them.

Hall
You just saw something climbing the stairs, you don't know what it was. There are some stairs here.

You can see Main door here.

>n
Living Room

* * *

>w
(first opening the Basculante)
It isn't something you can open.

>open Basculante
It isn't something you can open.

>opening Basculante
That's not a verb I recognise.

>w
(first opening the Basculante)
It isn't something you can open.

>look
Living Room

>look west
You see nothing unexpected in that direction.

>look
Living Room

>look around
You can't see any such thing.

>look to west
You can't see any such thing.

>look basculante
You can see a corpse lying on its back at the garage.

>s
I don't know weather I'm too drunk, but this light is way too dim, someone may be standing right in front of me and I will not see them.

Hall
There are some stairs here.

You can see Main door here.

>s
Porch
You can see Main door, Wooden chair, Old box (empty) and bucket (empty) here.

>take bucket
Taken.

>look
Porch
You can see Main door, Wooden chair and Old box (empty) here.

>drop bucket
Dropped.

* * *

- Damm, it is raining a lot. Everyone is still drunk at the party and it seems like no one is home. To make things worse, the power is out at the fraternity. - said David
party_game
An Interactive Fiction by Party Group
Release 1 / Serial number 210131 / Inform 7 build 6M62 (I6/v6.33 lib 6/12N) SD

Porch
You can see Main door, Main key, Wooden chair, Old box (in which are flashlight and batteries) and bucket (empty) here.

>entre main door
That's not a verb I recognise.

>enter main door
Shit, it's lockedOh no, can't get into the house because it is way too dark.

* * *

- Damm, it is raining a lot. Everyone is still drunk at the party and it seems like no one is home. To make things worse, the power is out at the fraternity. - said David
party_game
An Interactive Fiction by Party Group
Release 1 / Serial number 210131 / Inform 7 build 6M62 (I6/v6.33 lib 6/12N) SD

Porch
You can see Main door, Main key, Wooden chair, Old box (in which are flashlight and batteries) and bucket (empty) here.

>take main key
A chill runs up your spine
Taken.

>take flashlight and batteries
flashlight: Taken.
batteries: Taken.

>w
You can't go that way.

>n
Shit, it's locked

>unlock main door
What do you want to unlock Main door with?

>with main key
You can't see any such thing.

>unlock main door with main key
You unlock Main door.

* * *

>open main door
You open Main door.

>n
Oh no, can't get into the house because it is way too dark.

* * *

- Damm, it is raining a lot. Everyone is still drunk at the party and it seems like no one is home. To make things worse, the power is out at the fraternity. - said David
party_game
An Interactive Fiction by Party Group
Release 1 / Serial number 210131 / Inform 7 build 6M62 (I6/v6.33 lib 6/12N) SD

Porch
You can see Main door, Main key, Wooden chair, Old box (in which are flashlight and batteries) and bucket (empty) here.

>take
What do you want to take?

>main key
A chill runs up your spine
Taken.

>take flashlight and batteries
flashlight: Taken.
batteries: Taken.

>n
Shit, it's locked

>unlock main door with main key
You unlock Main door.

>n
Oh no, can't get into the house because it is way too dark.

>switch on flashlight
It's not much, but that will do.

You switch flashlight on.

>n
I don't know weather I'm too drunk, but this light is way too dim, someone may be standing right in front of me and I will not see them.

(first opening Main door)

Hall
You just saw something climbing the stairs, you don't know what it was. There are some stairs here.

You can see Main door here.

>n
Living Room

>e
Home Office
You can see Garage key here.

>look
Home Office
You can see Garage key here.

>w
Living Room

>e
Home Office
You can see Garage key here.

>taken garage key
That's not a verb I recognise.

>take garage key
Taken.

>look
Home Office

>inventory
You are carrying:
  Garage key
  batteries
  flashlight
  Main key

* * *

- Damm, it is raining a lot. Everyone is still drunk at the party and it seems like no one is home. To make things worse, the power is out at the fraternity. - said David
party_game
An Interactive Fiction by Party Group
Release 1 / Serial number 210131 / Inform 7 build 6M62 (I6/v6.33 lib 6/12N) SD

Porch
You can see Main door, Main key, Wooden chair, Old box (in which are flashlight and batteries) and bucket (empty) here.

>take main key and flashlight and batteries
Main key: A chill runs up your spine
Taken.
flashlight: Taken.
batteries: Taken.

>unlock main door with main key
You unlock Main door.

>switch on flashlight
It's not much, but that will do.

You switch flashlight on.

* * *

>n
I don't know weather I'm too drunk, but this light is way too dim, someone may be standing right in front of me and I will not see them.

(first opening Main door)

Hall
You just saw something climbing the stairs, you don't know what it was. There are some stairs here.

You can see Main door here.

>n
Living Room
You can see Home Office door here.

>e
(first opening Home Office door)
It seems to be locked.

>look
Living Room
You can see Home Office door here.

>look
Home Office
You can see Garage key here.

* * *

>look
Living Room
You can see Home Office door here.

>e
(first opening Home Office door)
It seems to be locked.

>look basculante
You can see a corpse lying on its back at the garage.

>n
Dining Room

* * *

>s
(first opening Garage door)
It seems to be locked.

>n
You can't go that way.

>s
(first opening Garage door)
It seems to be locked.

>s
(first opening Garage door)
It seems to be locked.

* * *

>s
Living Room
You can see Home Office door here.

>look basculante
You can see a corpse lying on its back at the garage.

* * *

>take main key and flashlight and batteries
Main key: A chill runs up your spine
Taken.
flashlight: Taken.
batteries: Taken.

>switch on flashlight
- It's not much, but that will do. - said David
You switch flashlight on.

* * *

>n
Living Room
You have a strange feeling when looking at the Basculante on your left. There are some Basculante here.

You can see Home Office door here.

>w
(first opening the Basculante)
It isn't something you can open.

>look Basculante
You can see a corpse lying on its back at the garage.

* * *

>s
- I don't know weather I'm too drunk, but this light is way too dim, someone may be standing right in front of me and I will not see them. - said David
Hall
There are some stairs here.

You can see Main door here.

>iup
That's not a verb I recognise.

>up
Upper Hall
You hear moans coming from the Large Bedroom. The place is very dark and very cold

You can see Bathroom door, Medium Bedroom door, Large Bedroom door and Small Bedroom door here.

>s
(first opening Bathroom door)
It seems to be locked.

>n
Large Bedroom
Somebody Screaming: I shouldn't have done this. But I had loved him too much!  |||  You listen a loud noise. ||| This room is such a mess.

You can see Large Bedroom door and Inner Bathroom door here.

>s
Upper Hall
The place is very dark and very cold

You can see Large Bedroom door, Bathroom door, Medium Bedroom door and Small Bedroom door here.

>n
Large Bedroom
This room is such a mess.

You can see Large Bedroom door and Inner Bathroom door here.

* * *

- Damm, it is raining a lot. Everyone is still drunk at the party and it seems like no one is home. To make things worse, the power is out at the fraternity. - said David
party_game
An Interactive Fiction by Party Group
Release 1 / Serial number 210131 / Inform 7 build 6M62 (I6/v6.33 lib 6/12N) SD

Porch
You can see Main door, Main key, Wooden chair, Old box (in which are flashlight and batteries) and bucket (empty) here.

>get main key, get flashlight
You can't see any such thing.

>get main key, get flashlight, get batteries, switch on flashlght, open main door with main key, go main door
You can't see any such thing.

>get main key; get flashlight, get batteries, switch on flashlght, open main door with main key; go main door
You can't see any such thing.

>get main key
A chill runs up your spine
Taken.

* * *

>switch on flashlight
- It's not much, but that will do.

You switch flashlight on.

>open main door with main key
You unlock Main door.

* * *

>up
Upper Hall
- Shit! What sond was that?

>w
You can't go that way.

>look
Upper Hall
- Shit! What sond was that?

>look
Upper Hall
- Shit! What sond was that?

* * *

- Damm, it is raining a lot. Everyone is still drunk at the party and it seems like no one is home. To make things worse, the power is out at the fraternity. - said David
party_game
An Interactive Fiction by Party Group
Release 1 / Serial number 210131 / Inform 7 build 6M62 (I6/v6.33 lib 6/12N) SD

Porch
You can see Main door, Main key, Wooden chair, Old box (in which are flashlight and batteries) and bucket (empty) here.

>z
Time passes.

>z
Time passes.

>s
You can't go that way.

>z
Time passes.

>time
That's not a verb I recognise.

>date
That's not a verb I recognise.